['5','5','5','5','5','5','5','5','5','5','5','5','5','5','6','.','.','.','.','.','.','.','.','.','.','.','.','.','.','.','.','.','.','.','.','.','.','.','.','.','.','4','5','5','5','5','5','5','5','5','5','5'],
['5','5','5','5','5','5','5','5','5','5','5','5','5','5','6','.','.','.','.','.','.','.','.','.','.','.','.','.','.','.','.','.','.','.','.','.','.','.','.','.','.','4','5','5','5','5','5','5','5','5','5','5'],
['5','5','5','5','5','5','5','5','5','5','5','5','5','5','6','.','.','.','.','.','.','.','.','.','.','.','.','.','.','.','.','.','.','.','.','.','.','.','.','.','.','4','5','5','5','5','5','5','5','5','5','5'],
['5','5','5','5','5','5','5','5','5','5','5','5','5','5','6','.','.','.','.','.','.','.','.','.','.','.','.','.','.','.','.','.','.','.','.','.','.','.','.','.','.','4','5','5','5','5','5','5','5','5','5','5'],
['5','5','5','5','5','5','5','5','5','5','5','5','5','5','6','.','.','.','.','.','.','.','.','.','.','.','.','.','.','.','.','.','.','.','.','.','.','.','.','.','.','4','5','5','5','5','5','5','5','5','5','5'],
['5','5','5','5','5','5','5','5','5','5','5','5','5','5','6','.','.','.','.','.','.','.','.','.','.','.','.','.','.','.','.','.','.','.','.','.','.','.','.','.','.','4','5','5','5','5','5','5','5','5','5','5'],
['5','5','5','5','5','5','5','5','5','5','5','5','5','5','>','.','.','.','.','.','.','.','.','.','.','.','.','.','.','.','.','.','.','.','.','.','.','.','.','.','.','4','5','5','5','5','5','5','5','5','5','5'],
['5','5','5','5','5','5','5','5','5','5','5','5','5','5','>','.','.','.','.','.','.','.','.','.','.','.','.','.','.','.','.','.','.','.','.','.','.','.','.','.','.','4','5','5','5','5','5','5','5','5','5','5'],
['5','5','5','5','5','5','5','5','v','5','5','5','5','5','>','.','.','.','.','.','.','.','.','.','.','.','.','.','.','.','.','.','.','.','.','.','.','.','.','.','.','4','5','5','5','5','5','5','5','5','5','5'],
['5','5','5','5','5','5','5','.','.','.','5','5','5','5','>','.','.','.','.','.','.','.','.','.','.','.','.','.','.','.','.','.','.','.','.','.','.','.','.','.','.','4','5','5','5','5','5','5','5','5','5','5'],
['5','5','5','5','5','5','5','.','7','.','5','5','5','5','6','.','.','.','.','.','.','.','.','.','.','.','.','.','.','.','.','.','.','.','.','.','.','.','.','.','.','4','5','5','5','5','5','5','5','5','5','5'],
['5','5','5','5','5','5','5','.','.','.','5','5','5','5','6','.','.','.','.','.','.','.','.','.','.','.','.','.','.','.','.','.','.','.','.','.','.','.','.','.','.','4','5','5','5','5','5','5','5','5','5','5'],
['5','5','5','5','5','5','5','.','5','.','5','5','5','5','6','.','.','.','.','.','.','.','.','.','.','.','.','.','.','.','.','.','.','.','.','.','.','.','.','.','.','4','5','5','5','5','5','5','5','5','5','5'],
['5','5','5','5','5','5','5','^','5','^','5','5','5','5','6','.','.','.','.','.','.','.','.','.','.','.','.','.','.','.','.','.','.','.','.','.','.','.','.','.','.','4','5','5','5','5','5','5','5','5','5','5'],
['5','5','5','5','5','5','5','5','5','5','5','5','5','5','6','.','.','.','.','.','.','.','.','.','.','.','.','.','.','.','.','.','.','.','.','.','.','.','.','.','.','4','5','5','5','5','5','5','5','5','5','5'],
['5','5','5','5','5','5','5','5','5','5','5','5','5','5','6','.','.','.','.','.','.','.','.','.','.','.','.','.','.','.','.','.','.','.','.','.','.','.','.','.','.','4','5','5','5','5','5','5','5','5','5','5'],
['5','5','5','5','5','5','5','5','5','5','5','5','5','5','6','.','.','.','.','.','.','.','.','.','.','.','.','.','.','.','.','.','.','.','.','.','.','.','.','.','.','4','5','5','5','5','5','5','5','5','5','5'],
['5','5','5','5','5','5','5','5','5','5','5','5','5','5','6','.','.','.','.','.','.','.','.','.','.','.','.','.','.','.','.','.','.','.','.','.','.','.','.','.','.','4','5','5','5','5','5','5','5','5','5','5'],
['5','5','5','5','5','5','5','5','5','5','5','5','5','5','6','2','2','2','2','2','2','2','3','.','.','.','.','1','2','2','2','^','^','2','2','2','2','2','2','2','2','4','5','5','5','5','5','5','5','5','5','5'],
['5','5','5','5','5','5','5','5','5','5','5','5','5','5','6','5','5','5','5','5','5','5','6','.','.','.','.','4','5','5','5','5','5','5','5','5','5','5','5','5','5','4','5','5','5','5','5','5','5','5','5','5'],
['5','5','5','5','5','5','5','5','5','5','5','5','5','5','6','5','5','5','5','5','1','3','6','.','.','.','.','4','5','5','5','5','5','5','5','5','5','5','5','5','5','4','5','5','5','5','5','5','5','5','5','5'],
['5','5','5','5','5','5','5','5','5','5','5','5','5','5','6','5','5','5','5','5','.','.','6','.','.','.','.','4','5','5','5','5','5','5','5','5','5','5','5','5','5','4','5','5','5','5','5','5','5','5','5','5'],
['5','5','5','5','5','5','5','1','3','5','5','5','5','5','6','5','5','5','5','5','^','^','6','.','.','.','.','7','8','5','5','5','5','5','5','5','5','5','5','5','5','4','5','5','5','5','5','5','5','5','5','5'],
['5','5','5','5','5','5','5','.','.','5','5','5','5','5','6','5','5','5','5','5','5','5','6','.','.','.','.','.','.','4','5','5','5','5','5','5','5','5','5','5','5','4','5','5','5','5','5','5','5','5','5','5'],
['5','5','5','5','5','5','5','^','^','5','5','5','5','5','6','5','5','5','5','5','5','5','5','2','3','.','.','.','.','7','5','5','5','5','5','5','5','5','5','5','5','4','5','5','5','5','5','5','5','5','5','5'],
['5','5','5','5','5','5','5','5','5','5','5','5','5','5','6','5','5','5','5','5','5','5','5','5','6','.','.','.','.','.','4','5','5','5','5','5','5','5','5','5','5','4','5','5','5','5','5','5','5','5','5','5'],
['5','5','5','5','5','5','5','5','5','5','5','5','5','5','6','5','5','5','5','5','5','5','5','5','6','.','.','.','.','.','4','5','5','5','5','5','5','5','5','5','5','4','5','5','5','5','5','5','5','5','5','5'],
['5','5','5','5','5','5','5','5','5','5','5','5','5','5','6','5','5','5','5','5','5','5','5','5','6','.','.','.','1','2','5','5','5','5','5','5','5','5','5','5','5','4','5','5','5','5','5','5','5','5','5','5'],
['5','5','5','5','5','5','5','5','5','5','5','5','5','5','6','5','5','5','5','5','5','5','5','5','6','.','.','.','4','5','5','5','5','5','5','5','5','5','5','5','5','4','5','5','5','5','5','5','5','5','5','5'],
['5','5','5','5','5','5','5','5','5','5','5','5','5','5','6','5','5','5','5','5','5','5','5','5','6','.','.','.','4','5','5','5','5','5','5','5','5','5','5','5','5','4','5','5','5','5','5','5','5','5','5','5'],
['5','5','5','5','5','5','5','5','5','5','5','5','5','5','6','5','5','5','5','5','5','5','8','8','9','.','.','.','4','5','5','5','5','5','5','5','5','5','5','5','5','4','5','5','5','5','5','5','5','5','5','5'],
['5','5','5','5','5','5','5','5','5','5','5','5','5','5','6','5','5','5','5','5','5','5','.','.','.','.','.','.','4','5','5','5','5','5','5','5','5','5','5','5','5','4','5','5','5','5','5','5','5','5','5','5'],
